Total of 375 samples information			
Sample ID	location	Breeds	Intestines
AHCeC1	Anhui	Peking ducks	Cecum
AHCeC2	Anhui	Peking ducks	Cecum
AHCeC3	Anhui	Peking ducks	Cecum
AHCeC4	Anhui	Peking ducks	Cecum
AHCeC5	Anhui	Peking ducks	Cecum
AHCeC6	Anhui	Peking ducks	Cecum
AHCeC7	Anhui	Peking ducks	Cecum
FJCeC1	Fujian	Partridge ducks	Cecum
FJCeC2	Fujian	Partridge ducks	Cecum
FJCeC3	Fujian	Partridge ducks	Cecum
FJCeC4	Fujian	Partridge ducks	Cecum
FJCeC5	Fujian	Partridge ducks	Cecum
FJCeC6	Fujian	Partridge ducks	Cecum
SSCeC-1	Guizhou	Partridge ducks	Cecum
SSCeC-10	Guizhou	Partridge ducks	Cecum
SSCeC-2	Guizhou	Partridge ducks	Cecum
SSCeC-3	Guizhou	Partridge ducks	Cecum
SSCeC-4	Guizhou	Partridge ducks	Cecum
SSCeC-5	Guizhou	Partridge ducks	Cecum
SSCeC-6	Guizhou	Partridge ducks	Cecum
SSCeC-7	Guizhou	Partridge ducks	Cecum
SSCeC-8	Guizhou	Partridge ducks	Cecum
SSCeC-9	Guizhou	Partridge ducks	Cecum
HBCeC1	Hebei	Peking ducks	Cecum
HBCeC2	Hebei	Peking ducks	Cecum
HBCeC3	Hebei	Peking ducks	Cecum
HBCeC4	Hebei	Peking ducks	Cecum
HBCeC5	Hebei	Peking ducks	Cecum
HBCeC6	Hebei	Peking ducks	Cecum
HEBCeC-10	Heilongjiang	Peking ducks	Cecum
HEBCeC-15	Heilongjiang	Peking ducks	Cecum
HEBCeC-17	Heilongjiang	Peking ducks	Cecum
HEBCeC-18	Heilongjiang	Peking ducks	Cecum
HEBCeC-21	Heilongjiang	Peking ducks	Cecum
HEBCeC-22	Heilongjiang	Peking ducks	Cecum
HEBCeC-25	Heilongjiang	Peking ducks	Cecum
HEBCeC-30	Heilongjiang	Peking ducks	Cecum
HEBCeC-4	Heilongjiang	Peking ducks	Cecum
HEBCeC-5	Heilongjiang	Peking ducks	Cecum
HEBCeC-7	Heilongjiang	Peking ducks	Cecum
HEBCeC-8	Heilongjiang	Peking ducks	Cecum
HNCeC10	Henan	Partridge ducks	Cecum
HNCeC11	Henan	Partridge ducks	Cecum
HNCeC12	Henan	Partridge ducks	Cecum
HNCeC13	Henan	Partridge ducks	Cecum
HNCeC14	Henan	Partridge ducks	Cecum
HNCeC15	Henan	Partridge ducks	Cecum
HNCeC16	Henan	Partridge ducks	Cecum
HNCeC17	Henan	Partridge ducks	Cecum
HNCeC18	Henan	Partridge ducks	Cecum
HNCeC4	Henan	Partridge ducks	Cecum
HNCeC5	Henan	Partridge ducks	Cecum
HNCeC6	Henan	Partridge ducks	Cecum
HNCeC7	Henan	Partridge ducks	Cecum
HNCeC8	Henan	Partridge ducks	Cecum
JSCeC1	Jiangsu	Partridge ducks	Cecum
JSCeC2	Jiangsu	Partridge ducks	Cecum
JSCeC3	Jiangsu	Partridge ducks	Cecum
JSCeC4	Jiangsu	Partridge ducks	Cecum
JSCeC5	Jiangsu	Partridge ducks	Cecum
JSCeC6	Jiangsu	Partridge ducks	Cecum
GZCeC-10	Jiangxi	Partridge ducks	Cecum
GZCeC-24	Jiangxi	Partridge ducks	Cecum
GZCeC-25	Jiangxi	Partridge ducks	Cecum
GZCeC-26	Jiangxi	Partridge ducks	Cecum
GZCeC-27	Jiangxi	Partridge ducks	Cecum
GZCeC-28	Jiangxi	Partridge ducks	Cecum
GZCeC-29	Jiangxi	Partridge ducks	Cecum
GZCeC-30	Jiangxi	Partridge ducks	Cecum
GZCeC-6	Jiangxi	Partridge ducks	Cecum
GZCeC-7	Jiangxi	Partridge ducks	Cecum
GZCeC-8	Jiangxi	Partridge ducks	Cecum
GZCeC-9	Jiangxi	Partridge ducks	Cecum
QDCoC1	Shandong	Peking ducks	Colorectum
QDCoC14	Shandong	Peking ducks	Colorectum
QDCoC15	Shandong	Peking ducks	Colorectum
QDCoC19	Shandong	Peking ducks	Colorectum
QDCoC2	Shandong	Peking ducks	Colorectum
QDCoC22	Shandong	Peking ducks	Colorectum
QDCoC29	Shandong	Peking ducks	Colorectum
QDCoC3	Shandong	Peking ducks	Colorectum
QDCoC30	Shandong	Peking ducks	Colorectum
QDCoC31	Shandong	Peking ducks	Colorectum
QDCoC35	Shandong	Peking ducks	Colorectum
SDCeC1	Shandong	Peking ducks	Cecum
SDCeC2	Shandong	Peking ducks	Cecum
SDCeC3	Shandong	Peking ducks	Cecum
SDCeC4	Shandong	Peking ducks	Cecum
SDCeC5	Shandong	Peking ducks	Cecum
SDCeC6	Shandong	Peking ducks	Cecum
CeC1	Shanghai	Muscovy ducks	Cecum
CeC108	Shanghai	Muscovy ducks	Cecum
CeC112	Shanghai	Muscovy ducks	Cecum
CeC113	Shanghai	Muscovy ducks	Cecum
CeC123	Shanghai	Muscovy ducks	Cecum
CeC124	Shanghai	Muscovy ducks	Cecum
CeC139	Shanghai	Muscovy ducks	Cecum
CeC149	Shanghai	Muscovy ducks	Cecum
CeC161	Shanghai	Muscovy ducks	Cecum
CeC164	Shanghai	Muscovy ducks	Cecum
CeC186	Shanghai	Muscovy ducks	Cecum
CeC200	Shanghai	Muscovy ducks	Cecum
CeC35	Shanghai	Muscovy ducks	Cecum
CeC41	Shanghai	Muscovy ducks	Cecum
CeC42	Shanghai	Muscovy ducks	Cecum
CeC51	Shanghai	Muscovy ducks	Cecum
CeC61	Shanghai	Muscovy ducks	Cecum
CeC66	Shanghai	Muscovy ducks	Cecum
CeC69	Shanghai	Muscovy ducks	Cecum
CeC70	Shanghai	Muscovy ducks	Cecum
SHCeC1	Shanghai	Muscovy ducks	Cecum
SHCeC12	Shanghai	Muscovy ducks	Cecum
SHCeC15	Shanghai	Muscovy ducks	Cecum
SHCeC16	Shanghai	Muscovy ducks	Cecum
SHCeC17	Shanghai	Muscovy ducks	Cecum
SHCeC18	Shanghai	Muscovy ducks	Cecum
SHCeC24	Shanghai	Muscovy ducks	Cecum
SHCeC26	Shanghai	Muscovy ducks	Cecum
SHCeC27	Shanghai	Muscovy ducks	Cecum
SHCeC28	Shanghai	Muscovy ducks	Cecum
SHCeC4	Shanghai	Muscovy ducks	Cecum
SHCeC7	Shanghai	Muscovy ducks	Cecum
CeC105	Zhejiang	Muscovy ducks	Cecum
CeC166	Zhejiang	Muscovy ducks	Cecum
CeC192	Zhejiang	Muscovy ducks	Cecum
CeC198	Zhejiang	Muscovy ducks	Cecum
CeC28	Zhejiang	Muscovy ducks	Cecum
CeC38	Zhejiang	Muscovy ducks	Cecum
CeC6	Zhejiang	Muscovy ducks	Cecum
CeC67	Zhejiang	Muscovy ducks	Cecum
CeC68	Zhejiang	Muscovy ducks	Cecum
CeC89	Zhejiang	Muscovy ducks	Cecum
MD14d_CeC_1	Zhejiang	Muscovy ducks	Cecum
MD14d_CeC_2	Zhejiang	Muscovy ducks	Cecum
MD14d_CeC_3	Zhejiang	Muscovy ducks	Cecum
MD14d_CeC_4	Zhejiang	Muscovy ducks	Cecum
MD14d_CeC_5	Zhejiang	Muscovy ducks	Cecum
MD14d_CeC_6	Zhejiang	Muscovy ducks	Cecum
MD14d_CeC_7	Zhejiang	Muscovy ducks	Cecum
MD14d_CeC_8	Zhejiang	Muscovy ducks	Cecum
MD3d_CeC_1	Zhejiang	Muscovy ducks	Cecum
MD3d_CeC_2	Zhejiang	Muscovy ducks	Cecum
MD3d_CeC_3	Zhejiang	Muscovy ducks	Cecum
MD3d_CeC_4	Zhejiang	Muscovy ducks	Cecum
MD3d_CeC_5	Zhejiang	Muscovy ducks	Cecum
MD3d_CeC_6	Zhejiang	Muscovy ducks	Cecum
MD3d_CeC_7	Zhejiang	Muscovy ducks	Cecum
MD3d_CeC_8	Zhejiang	Muscovy ducks	Cecum
MD42d_CeC1	Zhejiang	Muscovy ducks	Cecum
MD42d_CeC2	Zhejiang	Muscovy ducks	Cecum
MD42d_CeC3	Zhejiang	Muscovy ducks	Cecum
MD42d_CeC4	Zhejiang	Muscovy ducks	Cecum
MD42d_CeC5	Zhejiang	Muscovy ducks	Cecum
MD42d_CeC6	Zhejiang	Muscovy ducks	Cecum
MD42d_CeC7	Zhejiang	Muscovy ducks	Cecum
MD42d_CeC8	Zhejiang	Muscovy ducks	Cecum
MD70dCeC1	Zhejiang	Muscovy ducks	Cecum
MD70d_CeC1	Zhejiang	Muscovy ducks	Cecum
MD70dCeC2	Zhejiang	Muscovy ducks	Cecum
MD70d_CeC2	Zhejiang	Muscovy ducks	Cecum
MD70dCeC3	Zhejiang	Muscovy ducks	Cecum
MD70d_CeC3	Zhejiang	Muscovy ducks	Cecum
MD70dCeC4	Zhejiang	Muscovy ducks	Cecum
MD70d_CeC4	Zhejiang	Muscovy ducks	Cecum
MD70dCeC5	Zhejiang	Muscovy ducks	Cecum
MD70d_CeC5	Zhejiang	Muscovy ducks	Cecum
MD70dCeC6	Zhejiang	Muscovy ducks	Cecum
MD70d_CeC6	Zhejiang	Muscovy ducks	Cecum
MD70d_CeC7	Zhejiang	Muscovy ducks	Cecum
MD70d_CeC8	Zhejiang	Muscovy ducks	Cecum
MD70dCoC1	Zhejiang	Muscovy ducks	Colorectum
MD70dCoC2	Zhejiang	Muscovy ducks	Colorectum
MD70dCoC3	Zhejiang	Muscovy ducks	Colorectum
MD70dCoC4	Zhejiang	Muscovy ducks	Colorectum
MD70dCoC5	Zhejiang	Muscovy ducks	Colorectum
MD70dCoC7	Zhejiang	Muscovy ducks	Colorectum
MD70dduC1	Zhejiang	Muscovy ducks	Duodenum
MD70dduC2	Zhejiang	Muscovy ducks	Duodenum
MD70dduC3	Zhejiang	Muscovy ducks	Duodenum
MD70dduC4	Zhejiang	Muscovy ducks	Duodenum
MD70dduC5	Zhejiang	Muscovy ducks	Duodenum
MD70dduC7	Zhejiang	Muscovy ducks	Duodenum
MD70dIlC1	Zhejiang	Muscovy ducks	Ileum
MD70dIlC2	Zhejiang	Muscovy ducks	Ileum
MD70dIlC3	Zhejiang	Muscovy ducks	Ileum
MD70dIlC4	Zhejiang	Muscovy ducks	Ileum
MD70dIlC5	Zhejiang	Muscovy ducks	Ileum
MD70dIlC7	Zhejiang	Muscovy ducks	Ileum
MD70djeC1	Zhejiang	Muscovy ducks	Jejunum
MD70djeC2	Zhejiang	Muscovy ducks	Jejunum
MD70djeC3	Zhejiang	Muscovy ducks	Jejunum
MD70djeC4	Zhejiang	Muscovy ducks	Jejunum
MD70djeC5	Zhejiang	Muscovy ducks	Jejunum
MD70djeC6	Zhejiang	Muscovy ducks	Jejunum
MD7d_CeC_1	Zhejiang	Muscovy ducks	Cecum
MD7d_CeC_2	Zhejiang	Muscovy ducks	Cecum
MD7d_CeC_3	Zhejiang	Muscovy ducks	Cecum
MD7d_CeC_4	Zhejiang	Muscovy ducks	Cecum
MD7d_CeC_5	Zhejiang	Muscovy ducks	Cecum
MD7d_CeC_6	Zhejiang	Muscovy ducks	Cecum
MD7d_CeC_7	Zhejiang	Muscovy ducks	Cecum
MD7d_CeC_8	Zhejiang	Muscovy ducks	Cecum
PD14d_CeC_1	Zhejiang	Peking ducks	Cecum
PD14d_CeC_2	Zhejiang	Peking ducks	Cecum
PD14d_CeC_3	Zhejiang	Peking ducks	Cecum
PD14d_CeC_4	Zhejiang	Peking ducks	Cecum
PD14d_CeC_5	Zhejiang	Peking ducks	Cecum
PD14d_CeC_6	Zhejiang	Peking ducks	Cecum
PD14d_CeC_7	Zhejiang	Peking ducks	Cecum
PD14d_CeC_8	Zhejiang	Peking ducks	Cecum
PD3d_CeC_1	Zhejiang	Peking ducks	Cecum
PD3d_CeC_2	Zhejiang	Peking ducks	Cecum
PD3d_CeC_3	Zhejiang	Peking ducks	Cecum
PD3d_CeC_4	Zhejiang	Peking ducks	Cecum
PD3d_CeC_5	Zhejiang	Peking ducks	Cecum
PD3d_CeC_6	Zhejiang	Peking ducks	Cecum
PD3d_CeC_7	Zhejiang	Peking ducks	Cecum
PD3d_CeC_8	Zhejiang	Peking ducks	Cecum
PD42d_CeC1	Zhejiang	Peking ducks	Cecum
PD42d_CeC2	Zhejiang	Peking ducks	Cecum
PD42d_CeC3	Zhejiang	Peking ducks	Cecum
PD42d_CeC4	Zhejiang	Peking ducks	Cecum
PD42d_CeC5	Zhejiang	Peking ducks	Cecum
PD42d_CeC6	Zhejiang	Peking ducks	Cecum
PD42d_CeC7	Zhejiang	Peking ducks	Cecum
PD42d_CeC8	Zhejiang	Peking ducks	Cecum
PD70dCeC1	Zhejiang	Peking ducks	Cecum
PD70d_CeC1	Zhejiang	Peking ducks	Cecum
PD70dCeC2	Zhejiang	Peking ducks	Cecum
PD70d_CeC2	Zhejiang	Peking ducks	Cecum
PD70dCeC3	Zhejiang	Peking ducks	Cecum
PD70d_CeC3	Zhejiang	Peking ducks	Cecum
PD70dCeC4	Zhejiang	Peking ducks	Cecum
PD70d_CeC4	Zhejiang	Peking ducks	Cecum
PD70dCeC5	Zhejiang	Peking ducks	Cecum
PD70d_CeC5	Zhejiang	Peking ducks	Cecum
PD70dCeC6	Zhejiang	Peking ducks	Cecum
PD70d_CeC6	Zhejiang	Peking ducks	Cecum
PD70d_CeC7	Zhejiang	Peking ducks	Cecum
PD70d_CeC8	Zhejiang	Peking ducks	Cecum
PD70dCoC1	Zhejiang	Peking ducks	Colorectum
PD70dCoC2	Zhejiang	Peking ducks	Colorectum
PD70dCoC3	Zhejiang	Peking ducks	Colorectum
PD70dCoC4	Zhejiang	Peking ducks	Colorectum
PD70dCoC5	Zhejiang	Peking ducks	Colorectum
PD70dCoC6	Zhejiang	Peking ducks	Colorectum
PD70dduC1	Zhejiang	Peking ducks	Duodenum
PD70dduC2	Zhejiang	Peking ducks	Duodenum
PD70dduC3	Zhejiang	Peking ducks	Duodenum
PD70dduC4	Zhejiang	Peking ducks	Duodenum
PD70dduC5	Zhejiang	Peking ducks	Duodenum
PD70dduC6	Zhejiang	Peking ducks	Duodenum
PD70dIlC1	Zhejiang	Peking ducks	Ileum
PD70dIlC2	Zhejiang	Peking ducks	Ileum
PD70dIlC3	Zhejiang	Peking ducks	Ileum
PD70dIlC4	Zhejiang	Peking ducks	Ileum
PD70dIlC5	Zhejiang	Peking ducks	Ileum
PD70dIlC6	Zhejiang	Peking ducks	Ileum
PD70djeC1	Zhejiang	Peking ducks	Jejunum
PD70djeC2	Zhejiang	Peking ducks	Jejunum
PD70djeC3	Zhejiang	Peking ducks	Jejunum
PD70djeC4	Zhejiang	Peking ducks	Jejunum
PD70djeC5	Zhejiang	Peking ducks	Jejunum
PD70djeC6	Zhejiang	Peking ducks	Jejunum
PD7d_CeC_1	Zhejiang	Peking ducks	Cecum
PD7d_CeC_2	Zhejiang	Peking ducks	Cecum
PD7d_CeC_3	Zhejiang	Peking ducks	Cecum
PD7d_CeC_4	Zhejiang	Peking ducks	Cecum
PD7d_CeC_5	Zhejiang	Peking ducks	Cecum
PD7d_CeC_6	Zhejiang	Peking ducks	Cecum
PD7d_CeC_7	Zhejiang	Peking ducks	Cecum
PD7d_CeC_8	Zhejiang	Peking ducks	Cecum
SDQCeC10L	Zhejiang	Partridge ducks	Cecum
SDQCeC11L	Zhejiang	Partridge ducks	Cecum
SDQCeC1L	Zhejiang	Partridge ducks	Cecum
SDQCeC1R	Zhejiang	Partridge ducks	Cecum
SDQCeC2L	Zhejiang	Partridge ducks	Cecum
SDQCeC3L	Zhejiang	Partridge ducks	Cecum
SDQCeC4L	Zhejiang	Partridge ducks	Cecum
SDQCeC4R	Zhejiang	Partridge ducks	Cecum
SDQCeC5L	Zhejiang	Partridge ducks	Cecum
SDQCeC7R	Zhejiang	Partridge ducks	Cecum
SDQCeC8L	Zhejiang	Partridge ducks	Cecum
SDQCeC8R	Zhejiang	Partridge ducks	Cecum
SDQCeC9L	Zhejiang	Partridge ducks	Cecum
SDQCeC9R	Zhejiang	Partridge ducks	Cecum
SDQCoC1	Zhejiang	Partridge ducks	Colorectum
SDQCoC3	Zhejiang	Partridge ducks	Colorectum
SDQCoC4	Zhejiang	Partridge ducks	Colorectum
SDQCoC5	Zhejiang	Partridge ducks	Colorectum
SDQCoC7	Zhejiang	Partridge ducks	Colorectum
SDQCoC8	Zhejiang	Partridge ducks	Colorectum
SDQDuC1	Zhejiang	Partridge ducks	Duodenum
SDQDuC2	Zhejiang	Partridge ducks	Duodenum
SDQDuC3	Zhejiang	Partridge ducks	Duodenum
SDQDuC4	Zhejiang	Partridge ducks	Duodenum
SDQDuC5	Zhejiang	Partridge ducks	Duodenum
SDQDuC7	Zhejiang	Partridge ducks	Duodenum
SDQILC1	Zhejiang	Partridge ducks	Ileum
SDQILC2	Zhejiang	Partridge ducks	Ileum
SDQILC4	Zhejiang	Partridge ducks	Ileum
SDQILC5	Zhejiang	Partridge ducks	Ileum
SDQILC8	Zhejiang	Partridge ducks	Ileum
SDQILC9	Zhejiang	Partridge ducks	Ileum
SDQJeC1	Zhejiang	Partridge ducks	Jejunum
SDQJeC2	Zhejiang	Partridge ducks	Jejunum
SDQJeC4	Zhejiang	Partridge ducks	Jejunum
SDQJeC5	Zhejiang	Partridge ducks	Jejunum
SDQJeC7	Zhejiang	Partridge ducks	Jejunum
SDQJeC9	Zhejiang	Partridge ducks	Jejunum
SXCeC1	Zhejiang	Partridge ducks	Cecum
SXCeC2	Zhejiang	Partridge ducks	Cecum
SXCeC3	Zhejiang	Partridge ducks	Cecum
SXCeC4	Zhejiang	Partridge ducks	Cecum
SXCeC5	Zhejiang	Partridge ducks	Cecum
SXCeC6	Zhejiang	Partridge ducks	Cecum
WFHCeC11L	Zhejiang	Mallards	Cecum
WFHCeC12L	Zhejiang	Mallards	Cecum
WFHCeC13L	Zhejiang	Mallards	Cecum
WFHCeC14L	Zhejiang	Mallards	Cecum
WFHCeC16L	Zhejiang	Mallards	Cecum
WFHCeC1L	Zhejiang	Mallards	Cecum
WFHCeC21L	Zhejiang	Mallards	Cecum
WFHCeC22L	Zhejiang	Mallards	Cecum
WFHCeC23L	Zhejiang	Mallards	Cecum
WFHCeC24L	Zhejiang	Mallards	Cecum
WFHCeC25L	Zhejiang	Mallards	Cecum
WFHCeC2L	Zhejiang	Mallards	Cecum
WFHCeC3L	Zhejiang	Mallards	Cecum
WFHCeC4L	Zhejiang	Mallards	Cecum
WFHCeC6L	Zhejiang	Mallards	Cecum
WHYCeC1L	Zhejiang	Mallards	Cecum
WHYCeC1R	Zhejiang	Mallards	Cecum
WHYCeC2L	Zhejiang	Mallards	Cecum
WHYCeC2R	Zhejiang	Mallards	Cecum
WHYCeC3L	Zhejiang	Mallards	Cecum
WHYCeC3R	Zhejiang	Mallards	Cecum
WHYCeC4L	Zhejiang	Mallards	Cecum
WHYCeC4R	Zhejiang	Mallards	Cecum
WHYCeC5L	Zhejiang	Mallards	Cecum
WHYCeC5R	Zhejiang	Mallards	Cecum
WHYCeC6L	Zhejiang	Mallards	Cecum
WHYCeC6R	Zhejiang	Mallards	Cecum
WHYCeC7L	Zhejiang	Mallards	Cecum
WHYCeC7R	Zhejiang	Mallards	Cecum
WHYCeC8	Zhejiang	Mallards	Cecum
WHYCoC1	Zhejiang	Mallards	Colorectum
WHYCoC2	Zhejiang	Mallards	Colorectum
WHYCoC3	Zhejiang	Mallards	Colorectum
WHYCoC5	Zhejiang	Mallards	Colorectum
WHYCoC6	Zhejiang	Mallards	Colorectum
WHYCoC7	Zhejiang	Mallards	Colorectum
WHYDuC1	Zhejiang	Mallards	Duodenum
WHYDuC2	Zhejiang	Mallards	Duodenum
WHYDuC6	Zhejiang	Mallards	Duodenum
WHYDuC7	Zhejiang	Mallards	Duodenum
WHYDuC8	Zhejiang	Mallards	Duodenum
WHYILC1	Zhejiang	Mallards	Ileum
WHYILC3	Zhejiang	Mallards	Ileum
WHYILC4	Zhejiang	Mallards	Ileum
WHYILC5	Zhejiang	Mallards	Ileum
WHYILC6	Zhejiang	Mallards	Ileum
WHYILC8	Zhejiang	Mallards	Ileum
WHYJeC1	Zhejiang	Mallards	Jejunum
WHYJeC2	Zhejiang	Mallards	Jejunum
WHYJeC3	Zhejiang	Mallards	Jejunum
WHYJeC5	Zhejiang	Mallards	Jejunum
WHYJeC7	Zhejiang	Mallards	Jejunum
WHYJeC8	Zhejiang	Mallards	Jejunum
WNCeC1L	Zhejiang	Mallards	Cecum
WNCeC2L	Zhejiang	Mallards	Cecum
WNFCeC1L	Zhejiang	Mallards	Cecum
WNFCeC2L	Zhejiang	Mallards	Cecum
WNFCeC3L	Zhejiang	Mallards	Cecum
WNFCeC4L	Zhejiang	Mallards	Cecum
